---------------------------------------------------------------
Egységesített szavak listája
---------------------------------------------------------------
Alien = Idegen
Soldier = Katona
Start = Indítás

Advanced Warfare Center = Haditechnikai Központ
Resistance Comms = Kommunikációs Terminál


Accept = Elfogad
Back =  Vissza
Cancel =  Mégse
INFIRMARY = Gyengélkedo
Confirm = Megerosít
ENGINEERING = Gyártósor
SHADOW CHAMBER = Árnykamra
friendly fire = Baráti tûz
match = mérkozés
ranked = rangsorolt
unranked = nem rangsorolt
Overdrive Serum = túlhajtó szérum

Bar / Memorial = Bár / Emlékfal

Supplies = Készletek
Intel = Információ (Info)

Small Intel Cache = Kisebb Információmorzsák
Large Intel Cache = Nagyobb Információmorzsák

workshop = mûhely

ADVENT = ADVENT
MEC = MEC
Trooper = Gyalogos
Officer = Tiszt
Shieldbearer = Pajzshordozó
Enforcer =  ? (békefenntartó)
Stun lancer = ?
Shock Trooper = ?
Elite Lancer = ? 

dark event = ?
concealed = ? ( rejtve,rejtett,leplezett,lopakodó,eltakart,suttyonba,elmismásolt)